BOTH	B OW TH
FIFTEEN	F IH F T IY N
FIFTY	F IH F T IY
FIVE	F AY V
FOR	F AO R
FOR(2)	F ER
FOR(3)	F R ER
FORTY	F AO R T IY
LEFT	L EH F T
MINUTE	M IH N AH T
MINUTE(2)	M AY N UW T
MINUTE(3)	M AY N Y UW T
ONE	W AH N
ONE(2)	HH W AH N
RIGHT	R AY T
SECONDS	S EH K AH N D Z
SIDE	S AY D
SIDES	S AY D Z
SIXTY	S IH K S T IY
TEN	T EH N
THE	DH AH
THE(2)	DH IY
THIRTY	TH ER D IY
TWENTY	T W EH N T IY
WATER	W AO T ER
